Abdelmalek	Ahmed
Adamowicz	Solal
Adrou Bakkali	Sherine
Agogué	Jean-Max
Ahmed	Kais
Ahn	Chang-Yon
Aissa	Hassen
Aissaoui	Saad
Amar	Youcef
Andersen	Georg
Andreani	Simone
Anglio	Quentin
Araujo Cañas	Inés
Assayag	Nathaniel
Asselin	Etienne
Atallah	Mahdi
Azzi	Georges
Baccar	Skander
Bachmann	Samuel
Bader	Adrien
Badr	Sarah
Bag	Yousif
Baigalmaa	Tsogt
Baldisserotto	Loris
Balloux	Léonard
Banuls	Coralie
Barben	Margot
Barghorn	Jérémy
Barizza	Alessandro
Belakhdar	Ahmed
Belhaj	Omar
Bell	Eliott
Ben Mohamed	Nizar
Ben Salem	Ghalia
Bengelloun	Amine
Benkamoun	Imane
Bennani	Ghalia
Bensalah	Nassim
Bentaleb	Ali
Benzeroual	Zineb
Berardi	Massimo
Berger	Colin
Bergeron	Eugène
Bernard	Léo
Berrada	Ismael
Bichara	Rania
Bigot	Arthur
Bochatay	Robin
Bonny	Aymeric
Boo	Sébastien
Bouabid	Sharif
Bouaïssi	Menzo
Boucheny	Rayan
Bouchnak	Mohamed
Boughizane	Youssef
Bouguecha	Feriel
Bouhamria	Imade
Bourgoin	Alexandre
Bousseta	Amine
Bouthors	Sidonie
Bovard	Nicolas
Boyer	Benjamin
Bozhenko	Nikita
Bregnard	Titouan
Brenaut	Rémi
Bressaud	Eloi
Buloncelli	Stéphane
Bürki	Benjamin
Burnier	Allan
Buttier	Antoine
Carel	Alexandre
Castellari	Maximo
Catheland	Martin
Centonze	Alberto
Chahed Ouazzani	Adam
Chami Khazraji	Yassine
Changkakoti	Ilian
Chaouachi	Ahmed
Chappuis	Quentin
Chappuis	Vicky
Chapuis	Fabrice
Charbonnet	Yohann
Charif Chefchaouni	Rayane
Charles-Saigne	Gustave
Chaverot	Jérémy
Chávez Torres	Ariana
Chebaane	Houssein
Chevalley	Roxanne
Chlebny	Yuri
Chorfi	Youssef
Christen	Cherilyn
Chrysanthou	Athena
Chuat	Timothée
Ciotti	Mattia
Clivaz	Fabien
Coaguila	Alonso
Cohen	Adam
Coispeau	Baudoin
Colson	Antoine
Comte	Florian
Conde Losada	Gaël
Conicella	Sébastien
Cordonnier	Mai-Linh
Cornamusaz	Emile
Cornaz	Antoine
Corvaglia	Francesco
Costes	Lysandre
Coutaz	Cyrille
Crespo Pérez	Alejandro
Cretegny	Leander
Cseres	Leonard
Dagerskog	Simon
Dancau	Vlad
Danilovic	Luka
Dausque	Margaux
De Canteloube De Marmiés	Jeanne
De Gregorio	Loris
Déjean	Florian
Dervishaj	Arian
Desautel	Madeline
Deschenaux	Adrien
Deschryver-Larralde	Aitor
Desmaison	Simon
Devantay	Cloé
Dieudonné	Tanguy
Driss	Kenza
Ducourau	Maxime
Dufour	Agathe
Duong	Oscar
Duprat	Nicolas
Dupuy	Pierre
Duric	Ivan
Dussoix	Eric
Dutoit	Jonathan
El Ajeri	Khalil
El Idrissi Dafali	Jad
El Moutaoukil	Hana
El-Khoury	Ursula
Ertug	Nur
Espieux	Camille
Esseddik	Youssef
Fall	Rokhaya-Diamil
Faloughi	Lisa
Fang	Daniel
Farah	David
Fares	Albert
Faresse	Ilyas
Farhat	Marc
Fasterling	Pierre
Favre	Joachim
Favre	Thomas
Fendri	Melek
Fernández López	Silvia
Foodeei	Darius
Forestier	Gabin
Fragnière	Guillaume
Frei	Néhémie
Frossard	Laetitia
Fuentes Camacho	Pol
Funcasta Belinchon	Daniel
Gafsi	Amene
Galhaud	Léopold
Gamero García	Pablo
Garcia	Louis
Garcin	Samuel
Garin	Antoine
Gateau	Nils
Gellet	Pierre
Georges	Erik
Gerber	Cedric
Ghauri	Muhammad
Ghosn	Dalia
Giblain	Cyrus
Giordani	Victor
Giovannini	Yoan
Giraud	Louis
Giuliano	Alessio
Glaser	Philipp
Golay	Alexandra
Gomes Gonçalves	Ana
Gómez Vidal	Adrian
Gonzalez Rodriguez	Alejandra
Gonzalez-Gascou	Edgar
Goumaz	Alexandre
Goybet	François
Graham	Ethan
Grasset	Fabien
Greiner	Sarah
Gretillat	Julien
Gridel	Maximilien
Grieder	Lea
Gröli	Liess
Gross	Quentin
Guellaï	Dalil
Guerfali	Anas
Guerin Saturnino	Lucca
Habchi	Lucile
Haizmann	Arnaud
Hamane	Aya
Hamirifou	Mehdi
Hammoud	Omar
Hanna	Michael
Hawazine	Ilyas
Henriques	Adrien
Henriques Garfo	Sofia
Herbé	Loric
Herbron	Nathan
Herculano	Damian
Herrscher	Jules
Hervé	Louis
Hidri	Yasmine
Himmi	Myriam
Hirjy	Yann
Hsieh	Wei-En
Hu	Joana
Huberty	Florian
Hübner	Erik
Hugentobler	Jérémy
Huou	Alexandre
Hürlimann	Max
Iaconucci	Juan
Imghi	Mamoun
Imhof	Alec
Imhof	Maël
Iseni	Aladin
Ismaili	Engjëll
Jacome Noia Nuding	Johanna
Jadaa	Marc
Jaffar	Amir
Jallot	William
Jaouen	Benoît
Jia	Shuli
Jiménez Calles	Gabriel
Joseph	Marianne
Josso	Clément
Jun	Sara
Jung	Lucas
Junod	Nicolas
Juriens	Robin
Kachrad	Yassine
Kahane	Eden
Kallala	Ahmed
Kergrohenn	Elouan
Kharshoum	Malak
Kim	Hyoung
Kim	Nagyung
Knubel	Jean
Kobler	Sébastien
Kocman	Jindrich
Konukseven	Elvan
Krause	Mathis
Krone	Yannik
Kropf	Valentin
Kury	Dorian
Lablih	Moulay
Lachat	Fernando
Lachat	Mariano
Laginhas Gouveia	Pedro
Lagutova	Alexandra
Lambert	Nathanaël
Langumier	Dylan
Lannoye	Camille
Lanzmann	Yonathan
Laraqui-Housseini	Naïl
Laribi	Zakaria
Lassoued	Mohamed
Laval	Clotilde
Lazarini Sigg	Bruno
Lazarus	Jules
Le Béchec	Juliette
Le Dortz	Mathis
Lee	Heeyoun
Legris	Lucie
Lestiboudois	Maxime
Lhôte	Marius
Li	Chengwei
Lieberherr	Lorin
Liechti	Sacha
Lilljequist	Sandro
Lim	Sarah
Limond	Andrew
Lopez	Claire
Lozano	Cyrielle
M'Sadaa	Rassene
Mace	Noé
Machraoui	Réza
Magnin	Morgane
Malval	Théodore
Mamlouk	Yassine
Mangano	Eva
Mansour	Hussein
Manuguerra	Cassio
Maouchi	Ilan
Marchi	Paul
Marchon	Alexandra
Margeat	Arthur
Margery	Alexandre
Marinov	Deyan
Marmier	Julian
Martella	Leonardo
Massonnet	Evan
Mcnab	Eliot
Meharga	Mehdi
Mehenni	Ryan
Mellouk	Adam
Mellouli	Zeineb
Mérillat	Alain
Messmer	Témi
Michon	Quentin
Mignan	Edouard
Mimet	Idriss
Mir	Elias
Moebel	Timo
Mognol	Mathieu
Molinari	Thomas
Moréna	Clément
Moretti	Jacopo
Mouakhar	Hela
Mounan	Lina
Mourot	Alexandre
Moussalli	Georges
Muchembled	Martin
Müller	Célien
Muller	Thomas
Musat	Tiberiu-Ioan
Muster	Arthur
Nana Davies	Wesley
Nayar	Amitoj
Neike	Ella
Neji	Youssef
Neville Castro	Eduardo
Nguyen	Emmanuel
Nicole	Robin
Nkurunziza	Cyaka
Nomer	Cemre
Nordmann	Jean
Norén Vaisse	Alexandre
Novello	Ugo
Nowzary	Bijan
Ohl	Patrick
Ollier	Prune
Oray	Pinar
Ouazzani Chahdi	Khalil
Padrini	Lorenzo
Pantalos	Alexandros
Paoletti	Léo
Pasquier	Maïk
Pataky	Patrick
Paulino	Maël
Peiry	André
Pelletier	Gaston
Perbet	Jean
Perevoznyk	Mikhail
Pérez Pérez	Yago
Perret-Gentil	Thibault
Petit	Erwan
Peyronne	Mathis
Pham	Gia
Philippe	Marin
Picard	Antony
Piga	Chris
Pires Killer	Gustavo
Polka	Daniel
Porchet	Valentin
Porochyn	David
Quesnot	Paul
Raboud	Adam
Rachdi	Elias
Rafanomezana	Larry
Raithle	Luna
Ranieri	Giovanni
Raveendran	Harrishan
Ray	Julien
Reisons	Alberts
Renaud	Cléo
Rey	Loric
Reymond	Alice
Rezziki	Marwa
Richard	Mathis
Riedo	Iris
Rindlisbacher	Jonas
Robert	Noah
Robert	William
Rodriguez	Milan
Roth	Cassien
Rousset	Charles
Rrustemi	Ghulam
Rubat Du Mérac	Théotime
Saba	Nadim
Sadgal	Lina
Saint Girons	Michaël
Saleres	Capucine
Salmeron Vasylenko	Alexander
Sama Bouzigues	Ibrahima
Sandoz	Quentin
Saylan	Kerem
Schanen	Louis
Schifferli	Théo
Schlesser	Thomas
Schmid	Alexandre
Schneeberger	Valentin
Schneuwly	Jules
Schyrr	Timothy
Sicca	Pierrick
Silly	Emilien
Siminszky	Andrew
Skraber	Leonard
Smith	Harry
Sokhn	Thierry
Sollberger	Rafael
Soriano	Christopher
Sorrentino	Oliver
Spiess	Alexandre
Stanga	Zeno
Staszewicz	Jan
Stauffer	Samih
Sulzer	Jonas
Svet	Anton
Sy	Malick
Taghizad	Laura
Taouhid	Sofia
Teploukhov	Dmitry
Thai	Nathan
Thai Van	Jean-Xuan
Théron	François
Theubet	Camille
Thoral	Gaspard
Tille	Sébastien
Tissières	Nathan
Tissot	Antoine
Tissot-Daguette	Paul
Topalov	Ilian
Torjmen	Mehdi
Toukko	Rached
Trabelsi	Elyes
Tran	Loris
Trillo	Liam
Truong	Phuc-Hung
Tunçelli	Kerim
Turner	Oliver
Tymchenko	Matvey
Umabalan	Santhos
Upeski	Stefan
Urech	Shin
Urrea Bordones	Sophie
Valica	Adrian
Van Schalkwijk	Matisse
Venckunas	Aidas
Ventura	Vincent
Venturi	Alexandre
Verclytte	Mathurin
Verga	Loris
Vifian	Ylan
Vitalis	Guillaume
Vogt Rojas	Ernst
Wahidy	Yassine
Wikiera	Jacek
Wolf	Arthur
Xu	Lorie
Yang Zhang	Kevin
Yerly	Enzo
Yeshitila	Yofthahe
Yoon	Jiho
Yukhanov	Artur
Zamblera	Thomas
Zhukov	Mikhail
Ziadi	Skander
Ziemke	Finn
Zimmer	Martin
Zoghlami	Mehdi
Zuber	Matteo
Züger	Yoric
Zuloaga	Manuel
